A헲;MES;TIPO CONSULTA;FACEBOOK INBOX;FACEBOOK MURO;INSTAGRAN;TIK TOK;TWITTER;YOUTUBE;TOTAL
2021;AGOSTO;HORARIO /AGENCIAS;843;469;447;0;45;0;1804
2021;AGOSTO;NO CONTESTAN TELEFONO;396;83;4;0;60;0;543
2021;AGOSTO;CAMPA헤 SERVICIOS EN LINEA AMERICA TV;0;3;0;0;0;0;3
2021;AGOSTO;FECHA DE EMISION / DIGITO VERIFICADOR / OTROS DATOS DEL DNI;169;67;6;0;3;0;245
2021;AGOSTO;DEVOLUCION/VALIDEZ DE PAGO;164;123;86;0;12;0;385
2021;AGOSTO;TRAMITES DISCAPACIDAD;27;35;22;0;7;0;91
2021;AGOSTO;TRAMITE EXTRANJEROS;87;20;94;0;5;0;206
2021;AGOSTO;INFORMACION TERCEROS;391;402;37;0;5;0;835
2021;AGOSTO;EXTEMPORANEOS/INDOCUMENTADOS DNI AZUL;75;66;14;0;5;0;160
2021;AGOSTO;BONO;0;0;0;0;0;0;0
2021;AGOSTO;CONSULTA ELECCIONES/PADRON/MULTAS/DISPENSAS;31;28;12;0;1;0;72
2021;AGOSTO;HUELLAS DIGITALES;0;0;0;0;0;0;0
2021;AGOSTO;RECOJO DNI;1272;722;458;0;58;0;2510
2021;AGOSTO;CITA NO ATENDIDA;92;13;10;0;9;0;124
2021;AGOSTO;CITA NO DISPONIBLES;1032;1967;906;0;84;0;3989
2021;AGOSTO;MESA DE PARTES - INCONVENIENTES/DEMORA;214;78;35;0;9;0;336
2021;AGOSTO;COLAS EN OFICINAS;41;8;0;0;43;0;92
2021;AGOSTO;PVM FALLAS;21;7;3;0;0;0;31
2021;AGOSTO;PAGOS NO RECONOCIDOS;244;61;73;0;9;0;387
2021;AGOSTO;APP BIOFACIAL NO COMPATIBLE;185;85;179;0;21;0;470
2021;AGOSTO;APP BIOFACIAL NO PAGO;123;31;4;0;2;0;160
2021;AGOSTO;APP BIOFACIAL NO FOTO;247;100;91;0;7;0;445
2021;AGOSTO;INSCRIPCION /C4-C5- NOMBRES IGUALS / NEG SOLTERIA;233;85;59;0;7;0;384
2021;AGOSTO;NEGATIVA MATRIMONIO /SOLTERIA;139;52;54;0;10;0;255
2021;AGOSTO;COPIA DE ACTAS;559;279;156;0;13;0;1007
2021;AGOSTO;INSCRIPCION DE NACIMIENTO;318;159;88;0;22;0;587
2021;AGOSTO;INSCRIPCION DE CERTIFICADO DE DEFUNCION;49;17;27;0;9;0;102
2021;AGOSTO;RECTIFICACION PARTIDAS;218;97;108;0;11;0;434
2021;AGOSTO;EMISION PRIMERA VEZ (CAMBIO DE DNI AMA A ZUL);485;289;128;0;13;0;915
2021;AGOSTO;DUPLICADO;411;170;352;0;79;0;1012
2021;AGOSTO;RENOVACION;1657;1304;219;0;12;0;3192
2021;AGOSTO;RECTIFICACION DOMICILIO/ ESTADO CIVIL/OTROS DNI AZUL;565;367;106;0;7;0;1045
2021;AGOSTO;EMISION PRIMERA VEZ;404;187;57;0;17;0;665
2021;AGOSTO;DUPLICADO;149;102;123;0;6;0;380
2021;AGOSTO;RENOVACION;480;394;74;0;42;0;990
2021;AGOSTO;RECTIFICACION DOMICILIO/FOTO/OTROS;44;42;95;0;1;0;182
2021;AGOSTO;EMISION PRIMERA VEZ;564;361;121;0;8;0;1054
2021;AGOSTO;DUPLICADO;70;12;11;0;9;0;102
2021;AGOSTO;RENOVACION;119;14;7;0;2;0;142
2021;AGOSTO;RECTIFICACION DOMICILIO/ ESTADO CIVIL/OTROS DNI AZUL;110;15;10;0;4;0;139
2021;AGOSTO;RENOVACION CERTIF. DIGITAL/PERSONA NATURAL DNIE;12;3;1;0;1;0;17
2021;AGOSTO;RENOVACION PIN;0;1;0;0;0;0;1
2021;SEPTIEMBRE;HORARIO /AGENCIAS;829;430;384;0;22;0;1665
2021;SEPTIEMBRE;NO CONTESTAN TELEFONO;372;58;5;0;19;0;454
2021;SEPTIEMBRE;CAMPA헤 SERVICIOS EN LINEA AMERICA TV;0;1;0;0;0;0;1
2021;SEPTIEMBRE;FECHA DE EMISION / DIGITO VERIFICADOR / OTROS DATOS DEL DNI;637;165;219;0;5;0;1026
2021;SEPTIEMBRE;DEVOLUCION/VALIDEZ DE PAGO;248;109;94;0;6;0;457
2021;SEPTIEMBRE;TRAMITES DISCAPACIDAD;33;14;9;0;2;0;58
2021;SEPTIEMBRE;TRAMITE EXTRANJEROS;82;24;86;0;2;0;194
2021;SEPTIEMBRE;INFORMACION TERCEROS;103;449;32;0;3;0;587
2021;SEPTIEMBRE;EXTEMPORANEOS/INDOCUMENTADOS DNI AZUL;56;41;5;0;27;0;129
2021;SEPTIEMBRE;BONO;0;0;0;0;0;0;0
2021;SEPTIEMBRE;CONSULTA ELECCIONES/PADRON/MULTAS/DISPENSAS;91;233;108;0;32;0;464
2021;SEPTIEMBRE;HUELLAS DIGITALES;0;0;0;0;0;0;0
2021;SEPTIEMBRE;RECOJO DNI;1242;912;447;0;5;0;2606
2021;SEPTIEMBRE;CITA NO ATENDIDA;119;47;2;0;17;0;185
2021;SEPTIEMBRE;CITA NO DISPONIBLES;1151;2223;857;0;9;0;4240
2021;SEPTIEMBRE;MESA DE PARTES - INCONVENIENTES/DEMORA;209;194;25;0;11;0;439
2021;SEPTIEMBRE;COLAS EN OFICINAS;42;6;0;0;0;0;48
2021;SEPTIEMBRE;PVM FALLAS;36;6;4;0;3;0;49
2021;SEPTIEMBRE;PAGOS NO RECONOCIDOS;233;70;56;0;7;0;366
2021;SEPTIEMBRE;APP BIOFACIAL NO COMPATIBLE;301;96;133;0;2;0;532
2021;SEPTIEMBRE;APP BIOFACIAL NO PAGO;110;19;5;0;1;0;135
2021;SEPTIEMBRE;APP BIOFACIAL NO FOTO;342;118;85;0;2;0;547
2021;SEPTIEMBRE;INSCRIPCION /C4-C5- NOMBRES IGUALS / NEG SOLTERIA;358;108;66;0;3;0;535
2021;SEPTIEMBRE;NEGATIVA MATRIMONIO /SOLTERIA;123;53;21;0;4;0;201
2021;SEPTIEMBRE;COPIA DE ACTAS;671;236;166;0;5;0;1078
2021;SEPTIEMBRE;INSCRIPCION DE NACIMIENTO;340;144;68;0;13;0;565
2021;SEPTIEMBRE;INSCRIPCION DE CERTIFICADO DE DEFUNCION;52;32;13;0;3;0;100
2021;SEPTIEMBRE;RECTIFICACION PARTIDAS;229;96;127;0;9;0;461
2021;SEPTIEMBRE;EMISION PRIMERA VEZ (CAMBIO DE DNI AMA A ZUL);562;442;165;0;9;0;1178
2021;SEPTIEMBRE;DUPLICADO;452;296;270;0;17;0;1035
2021;SEPTIEMBRE;RENOVACION;1417;1582;171;0;5;0;3175
2021;SEPTIEMBRE;RECTIFICACION DOMICILIO/ ESTADO CIVIL/OTROS DNI AZUL;731;732;146;0;4;0;1613
2021;SEPTIEMBRE;EMISION PRIMERA VEZ;608;546;64;0;10;0;1228
2021;SEPTIEMBRE;DUPLICADO;158;199;101;0;6;0;464
2021;SEPTIEMBRE;RENOVACION;441;569;79;0;2;0;1091
2021;SEPTIEMBRE;RECTIFICACION DOMICILIO/FOTO/OTROS;91;59;109;0;11;0;270
2021;SEPTIEMBRE;EMISION PRIMERA VEZ;486;313;101;0;4;0;904
2021;SEPTIEMBRE;DUPLICADO;102;14;2;0;3;0;121
2021;SEPTIEMBRE;RENOVACION;128;44;11;0;2;0;185
2021;SEPTIEMBRE;RECTIFICACION DOMICILIO/ ESTADO CIVIL/OTROS DNI AZUL;76;13;1;0;1;0;91
2021;SEPTIEMBRE;RENOVACION CERTIF. DIGITAL/PERSONA NATURAL DNIE;13;9;3;0;2;0;27
2021;SEPTIEMBRE;RENOVACION PIN;1;0;2;0;1;0;4
2021;OCTUBRE;HORARIO /AGENCIAS;914;718;529;0;22;0;2183
2021;OCTUBRE;NO CONTESTAN TELEFONO;161;14;2;0;19;0;196
2021;OCTUBRE;CAMPA헤 SERVICIOS EN LINEA AMERICA TV;0;0;0;0;0;0;0
2021;OCTUBRE;FECHA DE EMISION / DIGITO VERIFICADOR / OTROS DATOS DEL DNI;668;239;208;0;5;0;1120
2021;OCTUBRE;DEVOLUCION/VALIDEZ DE PAGO;161;120;79;0;6;0;366
2021;OCTUBRE;TRAMITES DISCAPACIDAD;26;16;15;0;2;0;59
2021;OCTUBRE;TRAMITE EXTRANJEROS;24;8;66;0;2;0;100
2021;OCTUBRE;INFORMACION TERCEROS;110;418;61;0;3;0;592
2021;OCTUBRE;EXTEMPORANEOS/INDOCUMENTADOS DNI AZUL;45;23;0;0;27;0;95
2021;OCTUBRE;BONO;0;0;0;0;0;0;0
2021;OCTUBRE;CONSULTA ELECCIONES/PADRON/MULTAS/DISPENSAS;51;51;67;0;32;0;201
2021;OCTUBRE;HUELLAS DIGITALES;0;0;0;0;0;0;0
2021;OCTUBRE;RECOJO DNI;1006;832;429;0;5;0;2272
2021;OCTUBRE;CITA NO ATENDIDA;75;0;22;0;17;0;114
2021;OCTUBRE;CITA NO DISPONIBLES;283;38;239;0;9;0;569
2021;OCTUBRE;MESA DE PARTES - INCONVENIENTES/DEMORA;103;82;15;0;11;0;211
2021;OCTUBRE;COLAS EN OFICINAS;19;34;0;0;0;0;53
2021;OCTUBRE;PVM FALLAS;12;0;7;0;3;0;22
2021;OCTUBRE;PAGOS NO RECONOCIDOS;159;67;45;0;7;0;278
2021;OCTUBRE;APP BIOFACIAL NO COMPATIBLE;161;56;102;0;2;0;321
2021;OCTUBRE;APP BIOFACIAL NO PAGO;89;12;16;0;1;0;118
2021;OCTUBRE;APP BIOFACIAL NO FOTO;261;47;58;0;2;0;368
2021;OCTUBRE;INSCRIPCION /C4-C5- NOMBRES IGUALS / NEG SOLTERIA;305;91;91;0;3;0;490
2021;OCTUBRE;NEGATIVA MATRIMONIO /SOLTERIA;115;41;42;0;4;0;202
2021;OCTUBRE;COPIA DE ACTAS;478;256;155;0;5;0;894
2021;OCTUBRE;INSCRIPCION DE NACIMIENTO;298;136;79;0;13;0;526
2021;OCTUBRE;INSCRIPCION DE CERTIFICADO DE DEFUNCION;60;17;9;0;3;0;89
2021;OCTUBRE;RECTIFICACION PARTIDAS;181;141;110;0;9;0;441
2021;OCTUBRE;EMISION PRIMERA VEZ (CAMBIO DE DNI AMA A ZUL);446;319;53;0;9;0;827
2021;OCTUBRE;DUPLICADO;426;250;236;0;17;0;929
2021;OCTUBRE;RENOVACION;1021;1057;201;0;5;0;2284
2021;OCTUBRE;RECTIFICACION DOMICILIO/ ESTADO CIVIL/OTROS DNI AZUL;517;380;135;0;4;0;1036
2021;OCTUBRE;EMISION PRIMERA VEZ;339;205;50;0;10;0;604
2021;OCTUBRE;DUPLICADO;199;154;96;0;6;0;455
2021;OCTUBRE;RENOVACION;333;371;52;0;2;0;758
2021;OCTUBRE;RECTIFICACION DOMICILIO/FOTO/OTROS;57;32;92;0;11;0;192
2021;OCTUBRE;EMISION PRIMERA VEZ;321;265;50;0;4;0;640
2021;OCTUBRE;DUPLICADO;74;9;0;0;3;0;86
2021;OCTUBRE;RENOVACION;102;25;5;0;2;0;134
2021;OCTUBRE;RECTIFICACION DOMICILIO/ ESTADO CIVIL/OTROS DNI AZUL;55;5;5;0;1;0;66
2021;OCTUBRE;RENOVACION CERTIF. DIGITAL/PERSONA NATURAL DNIE;10;1;1;0;2;0;14
2021;OCTUBRE;RENOVACION PIN;0;1;0;0;1;0;2
2021;NOVIEMBRE;HORARIO /AGENCIAS;972;774;795;0;0;0;2541
2021;NOVIEMBRE;NO CONTESTAN TELEFONO;129;32;3;0;0;0;164
2021;NOVIEMBRE;CAMPA헤 SERVICIOS EN LINEA AMERICA TV;0;5;0;0;0;0;5
2021;NOVIEMBRE;FECHA DE EMISION / DIGITO VERIFICADOR / OTROS DATOS DEL DNI;540;222;190;0;0;0;952
2021;NOVIEMBRE;DEVOLUCION/VALIDEZ DE PAGO;156;167;101;0;0;0;424
2021;NOVIEMBRE;TRAMITES DISCAPACIDAD;25;29;47;0;0;0;101
2021;NOVIEMBRE;TRAMITE EXTRANJEROS;17;9;74;0;0;0;100
2021;NOVIEMBRE;INFORMACION TERCEROS;208;486;115;0;0;0;809
2021;NOVIEMBRE;EXTEMPORANEOS/INDOCUMENTADOS DNI AZUL;69;48;0;0;0;0;117
2021;NOVIEMBRE;BONO;0;0;10;0;0;0;10
2021;NOVIEMBRE;CONSULTA ELECCIONES/PADRON/MULTAS/DISPENSAS;21;12;62;0;0;0;95
2021;NOVIEMBRE;HUELLAS DIGITALES;0;0;0;0;0;0;0
2021;NOVIEMBRE;RECOJO DNI;887;870;507;0;0;0;2264
2021;NOVIEMBRE;CITA NO ATENDIDA;73;0;79;0;0;0;152
2021;NOVIEMBRE;CITA NO DISPONIBLES;179;5;198;0;0;0;382
2021;NOVIEMBRE;MESA DE PARTES - INCONVENIENTES/DEMORA;76;100;20;0;0;0;196
2021;NOVIEMBRE;COLAS EN OFICINAS;55;34;0;0;0;0;89
2021;NOVIEMBRE;PVM FALLAS;3;4;24;0;0;0;31
2021;NOVIEMBRE;PAGOS NO RECONOCIDOS;141;68;112;0;0;0;321
2021;NOVIEMBRE;APP BIOFACIAL NO COMPATIBLE;174;163;136;0;0;0;473
2021;NOVIEMBRE;APP BIOFACIAL NO PAGO;116;30;19;0;0;0;165
2021;NOVIEMBRE;APP BIOFACIAL NO FOTO;273;36;106;0;0;0;415
2021;NOVIEMBRE;INSCRIPCION /C4-C5- NOMBRES IGUALS / NEG SOLTERIA;384;184;58;0;0;0;626
2021;NOVIEMBRE;NEGATIVA MATRIMONIO /SOLTERIA;101;49;47;0;0;0;197
2021;NOVIEMBRE;COPIA DE ACTAS;589;351;207;0;0;0;1147
2021;NOVIEMBRE;INSCRIPCION DE NACIMIENTO;361;229;159;0;0;0;749
2021;NOVIEMBRE;INSCRIPCION DE CERTIFICADO DE DEFUNCION;38;11;20;0;0;0;69
2021;NOVIEMBRE;RECTIFICACION PARTIDAS;285;187;150;0;0;0;622
2021;NOVIEMBRE;EMISION PRIMERA VEZ (CAMBIO DE DNI AMA A ZUL);378;473;167;0;0;0;1018
2021;NOVIEMBRE;DUPLICADO;495;394;237;0;0;0;1126
2021;NOVIEMBRE;RENOVACION;1181;1441;281;0;0;0;2903
2021;NOVIEMBRE;RECTIFICACION DOMICILIO/ ESTADO CIVIL/OTROS DNI AZUL;483;491;180;0;0;0;1154
2021;NOVIEMBRE;EMISION PRIMERA VEZ;351;379;82;0;0;0;812
2021;NOVIEMBRE;DUPLICADO;178;318;127;0;0;0;623
2021;NOVIEMBRE;RENOVACION;409;754;109;0;0;0;1272
2021;NOVIEMBRE;RECTIFICACION DOMICILIO/FOTO/OTROS;50;97;105;0;0;0;252
2021;NOVIEMBRE;EMISION PRIMERA VEZ;423;437;85;0;0;0;945
2021;NOVIEMBRE;DUPLICADO;74;29;3;0;0;0;106
2021;NOVIEMBRE;RENOVACION;87;33;10;0;0;0;130
2021;NOVIEMBRE;RECTIFICACION DOMICILIO/ ESTADO CIVIL/OTROS DNI AZUL;53;3;10;0;0;0;66
2021;NOVIEMBRE;RENOVACION CERTIF. DIGITAL/PERSONA NATURAL DNIE;15;1;2;0;0;0;18
2021;NOVIEMBRE;RENOVACION PIN;1;1;0;0;0;0;2
2021;DICIEMBRE;HORARIO /AGENCIAS;1559;454;325;0;4;0;2342
2021;DICIEMBRE;NO CONTESTAN TELEFONO;1;2;0;0;0;0;3
2021;DICIEMBRE;CAMPA헤 SERVICIOS EN LINEA AMERICA TV;0;0;0;0;0;0;0
2021;DICIEMBRE;FECHA DE EMISION / DIGITO VERIFICADOR / OTROS DATOS DEL DNI;707;40;10;0;3;0;760
2021;DICIEMBRE;DEVOLUCION/VALIDEZ DE PAGO;277;88;50;0;5;0;420
2021;DICIEMBRE;TRAMITES DISCAPACIDAD;10;15;1;0;0;0;26
2021;DICIEMBRE;TRAMITE EXTRANJEROS;0;0;0;0;0;0;0
2021;DICIEMBRE;INFORMACION TERCEROS;9;3;0;0;0;0;12
2021;DICIEMBRE;EXTEMPORANEOS/INDOCUMENTADOS DNI AZUL;32;33;3;0;0;0;68
2021;DICIEMBRE;BONO;306;46;3;0;4;0;359
2021;DICIEMBRE;CONSULTA ELECCIONES/PADRON/MULTAS/DISPENSAS;66;93;37;0;4;0;200
2021;DICIEMBRE;HUELLAS DIGITALES;0;0;0;0;0;0;0
2021;DICIEMBRE;RECOJO DNI;778;456;92;0;4;0;1330
2021;DICIEMBRE;CITA NO ATENDIDA;0;0;0;0;0;0;0
2021;DICIEMBRE;CITA NO DISPONIBLES;0;0;0;0;0;0;0
2021;DICIEMBRE;MESA DE PARTES - INCONVENIENTES/DEMORA;174;34;9;0;10;0;227
2021;DICIEMBRE;COLAS EN OFICINAS;619;429;213;0;20;0;1281
2021;DICIEMBRE;PVM FALLAS;3;1;0;0;1;0;5
2021;DICIEMBRE;PAGOS NO RECONOCIDOS;67;3;3;0;3;0;76
2021;DICIEMBRE;APP BIOFACIAL NO COMPATIBLE;84;78;9;0;12;0;183
2021;DICIEMBRE;APP BIOFACIAL NO PAGO;8;5;1;0;0;0;14
2021;DICIEMBRE;APP BIOFACIAL NO FOTO;60;37;32;0;5;0;134
2021;DICIEMBRE;INSCRIPCION /C4-C5- NOMBRES IGUALS / NEG SOLTERIA;232;88;11;0;4;0;335
2021;DICIEMBRE;NEGATIVA MATRIMONIO /SOLTERIA;45;8;2;0;0;0;55
2021;DICIEMBRE;COPIA DE ACTAS;445;160;41;0;7;0;653
2021;DICIEMBRE;INSCRIPCION DE NACIMIENTO;209;117;44;0;1;0;371
2021;DICIEMBRE;INSCRIPCION DE CERTIFICADO DE DEFUNCION;5;9;0;0;1;0;15
2021;DICIEMBRE;RECTIFICACION PARTIDAS;133;85;12;0;2;0;232
2021;DICIEMBRE;EMISION PRIMERA VEZ (CAMBIO DE DNI AMA A ZUL);252;190;59;0;4;0;505
2021;DICIEMBRE;DUPLICADO;303;141;22;0;6;0;472
2021;DICIEMBRE;RENOVACION;1220;889;166;0;14;0;2289
2021;DICIEMBRE;RECTIFICACION DOMICILIO/ ESTADO CIVIL/OTROS DNI AZUL;352;235;34;0;4;0;625
2021;DICIEMBRE;EMISION PRIMERA VEZ;195;108;24;0;1;0;328
2021;DICIEMBRE;DUPLICADO;130;107;8;0;0;0;245
2021;DICIEMBRE;RENOVACION;311;328;50;0;1;0;690
2021;DICIEMBRE;RECTIFICACION DOMICILIO/FOTO/OTROS;47;22;3;0;0;0;72
2021;DICIEMBRE;EMISION PRIMERA VEZ;300;160;84;0;6;0;550
2021;DICIEMBRE;DUPLICADO;23;11;4;0;0;0;38
2021;DICIEMBRE;RENOVACION;42;16;13;0;1;0;72
2021;DICIEMBRE;RECTIFICACION DOMICILIO/ ESTADO CIVIL/OTROS DNI AZUL;32;10;6;0;0;0;48
2021;DICIEMBRE;RENOVACION CERTIF. DIGITAL/PERSONA NATURAL DNIE;4;1;1;0;2;0;8
2021;DICIEMBRE;RENOVACION PIN;3;0;0;0;0;0;3
2022;ENERO;AUTENTICACIONES DE FIRMAS/ACTAS;40;30;3;0;2;0;75
2022;ENERO;BONO;10;4;0;0;0;0;14
2022;ENERO;CAIDA SISTEMA;3;0;1;0;0;0;4
2022;ENERO;CAMBIO DNI A AZUL;286;161;45;0;0;0;492
2022;ENERO;CONSULTA ELECCIONES/PADRON/MULTAS/DISPENSAS;17;9;3;0;0;0;29
2022;ENERO;COPIA DE ACTAS;683;277;80;0;54;0;1094
2022;ENERO;DEMORA DE ENTREGA DEL DNI;0;0;0;0;0;0;0
2022;ENERO;DESBLOQUEO PIN DNIE;1;0;0;0;0;0;1
2022;ENERO;DEVOLUCION/VALIDEZ DE PAGO;354;121;78;0;10;0;563
2022;ENERO;DISCAPACIDAD DNI AMARILLO;2;0;0;0;0;0;2
2022;ENERO;DISCAPACIDAD DNI AZUL;15;2;0;0;0;0;17
2022;ENERO;DISCAPACIDAD DNIE;3;0;0;0;1;0;4
2022;ENERO;DUPLICADO DNI AMARILLO;140;99;19;0;0;0;258
2022;ENERO;DUPLICADO DNI AZUL;269;75;31;0;5;0;380
2022;ENERO;DUPLICADO DNIE;17;8;4;0;0;0;29
2022;ENERO;EMISION CERTIFICADO DIGITAL/ENTIDADES PUBLICAS;6;0;0;0;2;0;8
2022;ENERO;EMISION PRIMERA VEZ DNI AMARILLO;236;115;56;0;1;0;408
2022;ENERO;EMISION PRIMERA VEZ DNIE;344;148;65;0;5;0;562
2022;ENERO;ENVIVO FB;0;0;0;0;0;0;0
2022;ENERO;EXTEMPORANEOS DNI AMARILLO;1;1;1;0;0;0;3
2022;ENERO;EXTEMPORANEOS DNIE;0;0;1;0;0;0;1
2022;ENERO;EXTEMPORANEOS/INDOCUMENTADOS DNI AZUL;30;27;9;0;3;0;69
2022;ENERO;FECHA DE EMISION / DIGITO VERIFICADOR / OTROS DATOS DEL DNI;329;50;6;0;5;0;390
2022;ENERO;HABILITACIONES;2;1;0;0;0;0;3
2022;ENERO;HORARIO /AGENCIAS;1432;641;664;0;94;0;2831
2022;ENERO;IMPUGNACIONES;7;1;2;0;0;0;10
2022;ENERO;INCIDENCIA GOR;1;51;0;0;5;0;57
2022;ENERO;INSCRIPCION /C4-C5- NOMBRES IGUALS / NEG SOLTERIA;428;119;13;0;15;0;575
2022;ENERO;INSCRIPCION DE CERTIFICADO DE DEFUNCION;18;3;1;0;3;0;25
2022;ENERO;INSCRIPCION DE NACIMIENTO;281;97;59;0;8;0;445
2022;ENERO;LIBERACION DE PAGO;2;0;1;0;1;0;4
2022;ENERO;LIBERACION DE TRAMITE;0;0;0;0;0;0;0
2022;ENERO;MESA DE PARTES - INCONVENIENTES/DEMORA;45;13;3;0;22;0;83
2022;ENERO;MESA DE PARTES - ORIENTACION TRAMITES;45;27;18;0;13;0;103
2022;ENERO;OTRAS INCIDENCIAS;514;226;358;0;17;0;1115
2022;ENERO;PAGO NO REFLEJADO EN BASE DE DATOS;29;0;5;0;1;0;35
2022;ENERO;PASARELA VISA;0;1;1;0;0;0;2
2022;ENERO;PROBLEMAS - REGISTRO DIGITAL NACIMIENTO;0;0;0;0;2;0;2
2022;ENERO;PROBLEMAS - RENOVACION DNI WEB;26;8;0;0;15;0;49
2022;ENERO;PROBLEMAS - SISTEMA OPERATIVO IOS;0;0;0;0;0;0;0
2022;ENERO;PROBLEMAS DNI BIOFACIAL;57;43;6;0;1;0;107
2022;ENERO;PROBLEMAS EN USAR LA APLICACION;46;40;45;0;1;0;132
2022;ENERO;RECOJO DNI;1313;583;227;0;89;0;2212
2022;ENERO;RECTIFICACION DOMICILIO/ ESTADO CIVIL/OTROS DNI AZUL;395;107;61;0;4;0;567
2022;ENERO;RECTIFICACION DOMICILIO/ ESTADO CIVIL/OTROS DNIE;35;8;8;0;1;0;52
2022;ENERO;RECTIFICACION DOMICILIO/FOTO/OTROS DNI AMARILLO;33;11;4;0;0;0;48
2022;ENERO;RECTIFICACION PARTIDAS;178;69;20;0;6;0;273
2022;ENERO;RENOVACION CERTIF. DIGITAL/PERSONA NATURAL DNIE;8;0;0;0;0;0;8
2022;ENERO;RENOVACION CERTIFICADOS DIGITALES/PERSONA CONSULTA PUBLICA;2;1;0;0;0;0;3
2022;ENERO;RENOVACION DNI AMARILLO;365;235;74;0;8;0;682
2022;ENERO;RENOVACION DNI AZUL;991;412;126;0;42;0;1571
2022;ENERO;RENOVACION DNIE;15;8;21;0;16;0;60
2022;ENERO;UBICAR ACTA/DIGITALIZACION/ERROR ACTAS;1;0;0;0;0;0;1
2022;FEBRERO;AUTENTICACIONES DE FIRMAS/ACTAS;42;17;0;0;8;0;67
2022;FEBRERO;BONO;7;1;0;0;0;0;8
2022;FEBRERO;CAIDA SISTEMA;44;86;10;0;20;0;160
2022;FEBRERO;CAMBIO DNI A AZUL;262;148;50;0;0;0;460
2022;FEBRERO;CONSULTA ELECCIONES/PADRON/MULTAS/DISPENSAS;15;6;2;0;5;0;28
2022;FEBRERO;COPIA DE ACTAS;630;231;73;0;37;0;971
2022;FEBRERO;DEMORA DE ENTREGA DEL DNI;28;22;0;0;6;0;56
2022;FEBRERO;DESBLOQUEO PIN DNIE;3;1;0;0;0;0;4
2022;FEBRERO;DEVOLUCION/VALIDEZ DE PAGO;303;166;36;0;11;0;516
2022;FEBRERO;DISCAPACIDAD DNI AMARILLO;1;1;0;0;0;0;2
2022;FEBRERO;DISCAPACIDAD DNI AZUL;6;4;0;0;5;0;15
2022;FEBRERO;DISCAPACIDAD DNIE;1;1;0;0;0;0;2
2022;FEBRERO;DUPLICADO DNI AMARILLO;143;101;10;0;0;0;254
2022;FEBRERO;DUPLICADO DNI AZUL;283;81;24;0;11;0;399
2022;FEBRERO;DUPLICADO DNIE;25;10;4;0;4;0;43
2022;FEBRERO;EMISION CERTIFICADO DIGITAL/ENTIDADES PUBLICAS;5;1;0;0;0;0;6
2022;FEBRERO;EMISION PRIMERA VEZ DNI AMARILLO;254;142;35;0;1;0;432
2022;FEBRERO;EMISION PRIMERA VEZ DNIE;337;141;51;0;0;0;529
2022;FEBRERO;ENVIVO FB;0;0;0;0;0;0;0
2022;FEBRERO;EXTEMPORANEOS DNI AMARILLO;4;1;1;0;0;0;6
2022;FEBRERO;EXTEMPORANEOS DNIE;1;0;0;0;0;0;1
2022;FEBRERO;EXTEMPORANEOS/INDOCUMENTADOS DNI AZUL;24;29;6;0;5;0;64
2022;FEBRERO;FECHA DE EMISION / DIGITO VERIFICADOR / OTROS DATOS DEL DNI;228;75;6;0;10;0;319
2022;FEBRERO;HABILITACIONES;2;0;1;0;0;0;3
2022;FEBRERO;HORARIO /AGENCIAS;1603;595;304;0;43;0;2545
2022;FEBRERO;IMPUGNACIONES;4;22;2;0;1;0;29
2022;FEBRERO;INCIDENCIA GOR;3;50;0;0;11;0;64
2022;FEBRERO;INSCRIPCION /C4-C5- NOMBRES IGUALS / NEG SOLTERIA;328;127;26;0;7;0;488
2022;FEBRERO;INSCRIPCION DE CERTIFICADO DE DEFUNCION;19;2;2;0;2;0;25
2022;FEBRERO;INSCRIPCION DE NACIMIENTO;239;102;20;0;8;0;369
2022;FEBRERO;LIBERACION DE PAGO;3;0;0;0;0;0;3
2022;FEBRERO;LIBERACION DE TRAMITE;0;0;0;0;0;0;0
2022;FEBRERO;MESA DE PARTES - INCONVENIENTES/DEMORA;36;31;1;0;25;0;93
2022;FEBRERO;MESA DE PARTES - ORIENTACION TRAMITES;133;52;5;0;13;0;203
2022;FEBRERO;OTRAS INCIDENCIAS;658;362;292;0;54;0;1366
2022;FEBRERO;PAGO NO REFLEJADO EN BASE DE DATOS;21;0;3;0;0;0;24
2022;FEBRERO;PASARELA VISA;0;2;0;0;0;0;2
2022;FEBRERO;PROBLEMAS - REGISTRO DIGITAL NACIMIENTO;3;0;0;0;1;0;4
2022;FEBRERO;PROBLEMAS - RENOVACION DNI WEB;21;6;0;0;10;0;37
2022;FEBRERO;PROBLEMAS - SISTEMA OPERATIVO IOS;2;2;0;0;1;0;5
2022;FEBRERO;PROBLEMAS DNI BIOFACIAL;59;103;6;0;6;0;174
2022;FEBRERO;PROBLEMAS EN USAR LA APLICACION;55;32;27;0;4;0;118
2022;FEBRERO;RECOJO DNI;1440;1104;191;0;127;0;2862
2022;FEBRERO;RECTIFICACION DOMICILIO/ ESTADO CIVIL/OTROS DNI AZUL;419;179;31;0;15;0;644
2022;FEBRERO;RECTIFICACION DOMICILIO/ ESTADO CIVIL/OTROS DNIE;32;6;10;0;4;0;52
2022;FEBRERO;RECTIFICACION DOMICILIO/FOTO/OTROS DNI AMARILLO;43;14;4;0;0;0;61
2022;FEBRERO;RECTIFICACION PARTIDAS;166;62;16;0;2;0;246
2022;FEBRERO;RENOVACION CERTIF. DIGITAL/PERSONA NATURAL DNIE;3;1;2;0;0;0;6
2022;FEBRERO;RENOVACION CERTIFICADOS DIGITALES/PERSONA CONSULTA PUBLICA;3;0;1;0;0;0;4
2022;FEBRERO;RENOVACION DNI AMARILLO;283;253;58;0;16;0;610
2022;FEBRERO;RENOVACION DNI AZUL;868;524;119;0;39;0;1550
2022;FEBRERO;RENOVACION DNIE;33;5;8;0;53;0;99
2022;FEBRERO;UBICAR ACTA/DIGITALIZACION/ERROR ACTAS;0;0;0;0;0;0;0
2022;MARZO;AUTENTICACIONES DE FIRMAS/ACTAS;44;8;5;0;2;0;59
2022;MARZO;BONO;9;9;0;0;1;0;19
2022;MARZO;CAIDA SISTEMA;15;10;1;0;6;0;32
2022;MARZO;CAMBIO DNI A AZUL;289;122;19;1;1;0;432
2022;MARZO;CONSULTA ELECCIONES/PADRON/MULTAS/DISPENSAS;72;43;4;0;13;0;132
2022;MARZO;COPIA DE ACTAS;855;172;59;1;25;0;1112
2022;MARZO;DEMORA DE ENTREGA DEL DNI;774;132;22;0;120;0;1048
2022;MARZO;DESBLOQUEO PIN DNIE;1;0;2;0;1;0;4
2022;MARZO;DEVOLUCION/VALIDEZ DE PAGO;470;131;48;0;24;1;674
2022;MARZO;DISCAPACIDAD DNI AMARILLO;3;1;0;0;0;0;4
2022;MARZO;DISCAPACIDAD DNI AZUL;13;3;1;0;1;0;18
2022;MARZO;DISCAPACIDAD DNIE;0;1;0;0;1;0;2
2022;MARZO;DUPLICADO DNI AMARILLO;129;65;6;0;0;0;200
2022;MARZO;DUPLICADO DNI AZUL;428;108;27;0;6;0;569
2022;MARZO;DUPLICADO DNIE;21;8;4;0;0;0;33
2022;MARZO;EMISION CERTIFICADO DIGITAL/ENTIDADES PUBLICAS;8;0;0;0;4;0;12
2022;MARZO;EMISION PRIMERA VEZ DNI AMARILLO;269;95;29;0;3;0;396
2022;MARZO;EMISION PRIMERA VEZ DNIE;393;281;67;1;6;0;748
2022;MARZO;ENVIVO FB;0;10;0;0;0;0;10
2022;MARZO;EXTEMPORANEOS DNI AMARILLO;3;1;0;0;1;0;5
2022;MARZO;EXTEMPORANEOS DNIE;0;2;0;0;0;0;2
2022;MARZO;EXTEMPORANEOS/INDOCUMENTADOS DNI AZUL;57;29;6;1;1;0;94
2022;MARZO;FECHA DE EMISION / DIGITO VERIFICADOR / OTROS DATOS DEL DNI;383;90;4;0;11;0;488
2022;MARZO;HABILITACIONES;6;2;2;0;0;0;10
2022;MARZO;HORARIO /AGENCIAS;3111;639;300;2;43;7;4102
2022;MARZO;IMPUGNACIONES;8;33;4;0;0;0;45
2022;MARZO;INCIDENCIA GOR;3;27;0;0;1;1;32
2022;MARZO;INSCRIPCION /C4-C5- NOMBRES IGUALS / NEG SOLTERIA;414;86;19;0;8;1;528
2022;MARZO;INSCRIPCION DE CERTIFICADO DE DEFUNCION;14;4;0;0;0;0;18
2022;MARZO;INSCRIPCION DE NACIMIENTO;249;85;24;1;8;0;367
2022;MARZO;LIBERACION DE PAGO;2;0;0;0;0;0;2
2022;MARZO;LIBERACION DE TRAMITE;0;0;0;0;0;0;0
2022;MARZO;MESA DE PARTES - INCONVENIENTES/DEMORA;60;6;0;0;19;0;85
2022;MARZO;MESA DE PARTES - ORIENTACION TRAMITES;237;62;44;0;16;0;359
2022;MARZO;OTRAS INCIDENCIAS;103;33;12;1;14;0;163
2022;MARZO;PAGO NO REFLEJADO EN BASE DE DATOS;45;0;4;0;1;0;50
2022;MARZO;PASARELA VISA;0;0;0;0;0;0;0
2022;MARZO;PROBLEMAS - REGISTRO DIGITAL NACIMIENTO;1;0;0;0;0;0;1
2022;MARZO;PROBLEMAS - RENOVACION DNI WEB;144;10;4;0;9;0;167
2022;MARZO;PROBLEMAS - SISTEMA OPERATIVO IOS;11;0;1;0;2;0;14
2022;MARZO;PROBLEMAS DNI BIOFACIAL;98;85;11;0;4;3;201
2022;MARZO;PROBLEMAS EN USAR LA APLICACION;83;44;14;0;0;0;141
2022;MARZO;RECOJO DNI;2562;1776;236;10;444;3;5031
2022;MARZO;RECTIFICACION DOMICILIO/ ESTADO CIVIL/OTROS DNI AZUL;610;195;56;2;17;0;880
2022;MARZO;RECTIFICACION DOMICILIO/ ESTADO CIVIL/OTROS DNIE;37;14;12;0;3;0;66
2022;MARZO;RECTIFICACION DOMICILIO/FOTO/OTROS DNI AMARILLO;74;23;4;0;0;0;101
2022;MARZO;RECTIFICACION PARTIDAS;272;70;12;1;2;0;357
2022;MARZO;RENOVACION CERTIF. DIGITAL/PERSONA NATURAL DNIE;15;6;4;0;1;0;26
2022;MARZO;RENOVACION CERTIFICADOS DIGITALES/PERSONA CONSULTA PUBLICA;1;0;0;0;0;0;1
2022;MARZO;RENOVACION DNI AMARILLO;314;176;38;0;8;0;536
2022;MARZO;RENOVACION DNI AZUL;1216;867;131;6;19;1;2240
2022;MARZO;RENOVACION DNIE;35;7;22;0;38;0;102
2022;MARZO;UBICAR ACTA/DIGITALIZACION/ERROR ACTAS;2;4;0;0;0;0;6
2022;ABRIL;AUTENTICACIONES DE FIRMAS/ACTAS;47;20;1;0;0;0;68
2022;ABRIL;BONO;1;2;0;0;0;0;3
2022;ABRIL;CAIDA SISTEMA;339;191;79;0;13;0;622
2022;ABRIL;CAMBIO DNI A AZUL;159;42;14;8;0;2;225
2022;ABRIL;CONSULTA ELECCIONES/PADRON/MULTAS/DISPENSAS;44;22;2;0;3;0;71
2022;ABRIL;COPIA DE ACTAS;601;144;53;0;15;0;813
2022;ABRIL;DEMORA DE ENTREGA DEL DNI;296;13;162;0;11;0;482
2022;ABRIL;DESBLOQUEO PIN DNIE;1;0;1;0;0;0;2
2022;ABRIL;DEVOLUCION/VALIDEZ DE PAGO;337;115;45;0;11;2;510
2022;ABRIL;DISCAPACIDAD DNI AMARILLO;1;4;0;0;1;0;6
2022;ABRIL;DISCAPACIDAD DNI AZUL;13;6;0;0;0;0;19
2022;ABRIL;DISCAPACIDAD DNIE;1;0;0;0;0;0;1
2022;ABRIL;DUPLICADO DNI AMARILLO;95;37;4;0;0;0;136
2022;ABRIL;DUPLICADO DNI AZUL;268;76;15;1;3;0;363
2022;ABRIL;DUPLICADO DNIE;30;7;2;1;1;0;41
2022;ABRIL;EMISION CERTIFICADO DIGITAL/ENTIDADES PUBLICAS;6;3;0;0;0;0;9
2022;ABRIL;EMISION PRIMERA VEZ DNI AMARILLO;172;48;13;0;1;0;234
2022;ABRIL;EMISION PRIMERA VEZ DNIE;290;386;39;2;1;1;719
2022;ABRIL;ENVIVO FB;1;39;0;0;0;0;40
2022;ABRIL;EXTEMPORANEOS DNI AMARILLO;0;1;0;0;0;0;1
2022;ABRIL;EXTEMPORANEOS DNIE;1;0;0;0;0;0;1
2022;ABRIL;EXTEMPORANEOS/INDOCUMENTADOS DNI AZUL;33;18;4;0;0;0;55
2022;ABRIL;FECHA DE EMISION / DIGITO VERIFICADOR / OTROS DATOS DEL DNI;263;33;4;0;1;1;302
2022;ABRIL;HABILITACIONES;6;0;1;0;0;0;7
2022;ABRIL;HORARIO /AGENCIAS;3140;674;248;5;30;2;4099
2022;ABRIL;IMPUGNACIONES;1;2;1;0;1;0;5
2022;ABRIL;INCIDENCIA GOR;0;46;0;0;1;0;47
2022;ABRIL;INSCRIPCION /C4-C5- NOMBRES IGUALS / NEG SOLTERIA;263;48;12;1;11;0;335
2022;ABRIL;INSCRIPCION DE CERTIFICADO DE DEFUNCION;16;5;2;0;2;0;25
2022;ABRIL;INSCRIPCION DE NACIMIENTO;246;213;17;0;1;0;477
2022;ABRIL;LIBERACION DE PAGO;3;2;0;0;0;0;5
2022;ABRIL;LIBERACION DE TRAMITE;3;0;0;0;0;0;3
2022;ABRIL;MESA DE PARTES - INCONVENIENTES/DEMORA;48;2;0;0;10;0;60
2022;ABRIL;MESA DE PARTES - ORIENTACION TRAMITES;163;66;10;0;9;0;248
2022;ABRIL;OTRAS INCIDENCIAS;82;36;14;0;9;1;142
2022;ABRIL;PAGO NO REFLEJADO EN BASE DE DATOS;43;2;3;0;1;0;49
2022;ABRIL;PASARELA VISA;0;0;0;0;0;0;0
2022;ABRIL;PROBLEMAS - REGISTRO DIGITAL NACIMIENTO;3;0;0;0;0;0;3
2022;ABRIL;PROBLEMAS - RENOVACION DNI WEB;166;3;2;0;3;0;174
2022;ABRIL;PROBLEMAS - SISTEMA OPERATIVO IOS;5;0;0;0;0;0;5
2022;ABRIL;PROBLEMAS DNI BIOFACIAL;46;59;8;1;5;7;126
2022;ABRIL;PROBLEMAS EN USAR LA APLICACION;72;30;17;0;2;3;124
2022;ABRIL;RECOJO DNI;1655;829;108;4;112;3;2711
2022;ABRIL;RECTIFICACION DOMICILIO/ ESTADO CIVIL/OTROS DNI AZUL;467;177;45;4;14;5;712
2022;ABRIL;RECTIFICACION DOMICILIO/ ESTADO CIVIL/OTROS DNIE;30;13;2;1;1;0;47
2022;ABRIL;RECTIFICACION DOMICILIO/FOTO/OTROS DNI AMARILLO;51;28;1;0;0;0;80
2022;ABRIL;RECTIFICACION PARTIDAS;188;97;15;1;1;0;302
2022;ABRIL;RENOVACION CERTIF. DIGITAL/PERSONA NATURAL DNIE;6;5;1;0;0;0;12
2022;ABRIL;RENOVACION CERTIFICADOS DIGITALES/PERSONA CONSULTA PUBLICA;3;0;0;0;0;0;3
2022;ABRIL;RENOVACION DNI AMARILLO;153;159;35;6;3;1;357
2022;ABRIL;RENOVACION DNI AZUL;636;478;28;0;14;0;1156
2022;ABRIL;RENOVACION DNIE;34;24;6;0;19;0;83
2022;ABRIL;UBICAR ACTA/DIGITALIZACION/ERROR ACTAS;6;0;0;0;3;0;9
2022;MAYO;AUTENTICACIONES DE FIRMAS/ACTAS;51;8;0;0;0;0;59
2022;MAYO;BONO;2;1;0;0;0;0;3
2022;MAYO;CAIDA SISTEMA;57;70;5;1;7;0;140
2022;MAYO;CAMBIO DNI A AZUL;143;21;9;0;0;0;173
2022;MAYO;CONSULTA ELECCIONES/PADRON/MULTAS/DISPENSAS;196;81;34;2;13;0;326
2022;MAYO;COPIA DE ACTAS;470;119;36;0;22;4;651
2022;MAYO;DEMORA DE ENTREGA DEL DNI;22;2;1;0;0;0;25
2022;MAYO;DESBLOQUEO PIN DNIE;14;2;1;0;0;0;17
2022;MAYO;DEVOLUCION/VALIDEZ DE PAGO;396;112;35;0;16;2;561
2022;MAYO;DISCAPACIDAD DNI AMARILLO;2;1;1;0;0;0;4
2022;MAYO;DISCAPACIDAD DNI AZUL;12;5;3;0;0;0;20
2022;MAYO;DISCAPACIDAD DNIE;0;0;0;0;0;0;0
2022;MAYO;DUPLICADO DNI AMARILLO;80;39;4;0;0;0;123
2022;MAYO;DUPLICADO DNI AZUL;278;86;18;1;4;0;387
2022;MAYO;DUPLICADO DNIE;16;8;1;0;0;0;25
2022;MAYO;EMISION CERTIFICADO DIGITAL/ENTIDADES PUBLICAS;13;0;0;0;2;0;15
2022;MAYO;EMISION PRIMERA VEZ DNI AMARILLO;179;68;18;0;0;0;265
2022;MAYO;EMISION PRIMERA VEZ DNIE;330;428;60;0;2;0;820
2022;MAYO;ENVIVO FB;0;15;0;0;0;0;15
2022;MAYO;EXTEMPORANEOS DNI AMARILLO;0;0;0;0;0;0;0
2022;MAYO;EXTEMPORANEOS DNIE;1;1;0;0;0;0;2
2022;MAYO;EXTEMPORANEOS/INDOCUMENTADOS DNI AZUL;31;17;7;0;7;0;62
2022;MAYO;FECHA DE EMISION / DIGITO VERIFICADOR / OTROS DATOS DEL DNI;262;24;7;0;1;1;295
2022;MAYO;HABILITACIONES;19;1;1;0;0;0;21
2022;MAYO;HORARIO /AGENCIAS;3208;654;233;3;28;1;4127
2022;MAYO;IMPUGNACIONES;3;1;1;0;0;0;5
2022;MAYO;INCIDENCIA GOR;1;40;0;1;0;0;42
2022;MAYO;INSCRIPCION /C4-C5- NOMBRES IGUALS / NEG SOLTERIA;210;45;13;0;8;0;276
2022;MAYO;INSCRIPCION DE CERTIFICADO DE DEFUNCION;11;8;2;0;2;0;23
2022;MAYO;INSCRIPCION DE NACIMIENTO;210;73;14;0;3;0;300
2022;MAYO;LIBERACION DE PAGO;3;1;0;0;0;0;4
2022;MAYO;LIBERACION DE TRAMITE;0;0;0;0;0;0;0
2022;MAYO;MESA DE PARTES - INCONVENIENTES/DEMORA;43;0;1;0;8;0;52
2022;MAYO;MESA DE PARTES - ORIENTACION TRAMITES;242;57;25;0;9;0;333
2022;MAYO;OTRAS INCIDENCIAS;113;50;17;0;7;0;187
2022;MAYO;PAGO NO REFLEJADO EN BASE DE DATOS;38;1;1;0;0;0;40
2022;MAYO;PASARELA VISA;0;0;0;0;0;0;0
2022;MAYO;PROBLEMAS - REGISTRO DIGITAL NACIMIENTO;0;0;0;0;1;0;1
2022;MAYO;PROBLEMAS - RENOVACION DNI WEB;160;3;3;0;0;0;166
2022;MAYO;PROBLEMAS - SISTEMA OPERATIVO IOS;4;1;0;0;1;0;6
2022;MAYO;PROBLEMAS DNI BIOFACIAL;50;52;3;1;7;5;118
2022;MAYO;PROBLEMAS EN USAR LA APLICACION;70;64;14;3;3;6;160
2022;MAYO;RECOJO DNI;1154;437;73;1;19;6;1690
2022;MAYO;RECTIFICACION DOMICILIO/ ESTADO CIVIL/OTROS DNI AZUL;555;216;43;0;6;3;823
2022;MAYO;RECTIFICACION DOMICILIO/ ESTADO CIVIL/OTROS DNIE;49;22;4;0;4;0;79
2022;MAYO;RECTIFICACION DOMICILIO/FOTO/OTROS DNI AMARILLO;58;20;1;0;0;0;79
2022;MAYO;RECTIFICACION PARTIDAS;156;61;20;1;9;0;247
2022;MAYO;RENOVACION CERTIF. DIGITAL/PERSONA NATURAL DNIE;13;0;0;1;0;0;14
2022;MAYO;RENOVACION CERTIFICADOS DIGITALES/PERSONA CONSULTA PUBLICA;2;0;0;0;0;0;2
2022;MAYO;RENOVACION DNI AMARILLO;157;135;20;1;4;1;318
2022;MAYO;RENOVACION DNI AZUL;630;953;69;0;12;0;1664
2022;MAYO;RENOVACION DNIE;59;18;6;13;13;14;123
2022;MAYO;UBICAR ACTA/DIGITALIZACION/ERROR ACTAS;5;0;0;0;1;0;6
2022;JUNIO;AUTENTICACIONES DE FIRMAS/ACTAS;35;8;4;0;2;0;49
2022;JUNIO;BONO;3;2;0;0;0;0;5
2022;JUNIO;CAIDA SISTEMA;68;56;6;0;4;0;134
2022;JUNIO;CAMBIO DNI A AZUL;135;118;20;0;0;1;274
2022;JUNIO;CONSULTA ELECCIONES/PADRON/MULTAS/DISPENSAS;156;92;38;0;2;0;288
2022;JUNIO;COPIA DE ACTAS;398;158;61;0;10;6;633
2022;JUNIO;DEMORA DE ENTREGA DEL DNI;29;1;4;0;0;0;34
2022;JUNIO;DESBLOQUEO PIN DNIE;4;1;2;0;0;0;7
2022;JUNIO;DEVOLUCION/VALIDEZ DE PAGO;341;124;45;0;3;0;513
2022;JUNIO;DISCAPACIDAD DNI AMARILLO;3;3;0;0;0;0;6
2022;JUNIO;DISCAPACIDAD DNI AZUL;15;10;9;0;0;1;35
2022;JUNIO;DISCAPACIDAD DNIE;0;0;0;0;0;0;0
2022;JUNIO;DUPLICADO DNI AMARILLO;63;51;6;0;1;0;121
2022;JUNIO;DUPLICADO DNI AZUL;254;115;19;0;0;1;389
2022;JUNIO;DUPLICADO DNIE;13;16;2;0;1;0;32
2022;JUNIO;EMISION CERTIFICADO DIGITAL/ENTIDADES PUBLICAS;5;0;0;0;1;0;6
2022;JUNIO;EMISION PRIMERA VEZ DNI AMARILLO;129;77;20;0;0;1;227
2022;JUNIO;EMISION PRIMERA VEZ DNIE;222;284;75;3;5;0;589
2022;JUNIO;ENVIVO FB;0;17;0;0;0;0;17
2022;JUNIO;EXTEMPORANEOS DNI AMARILLO;5;2;2;0;0;0;9
2022;JUNIO;EXTEMPORANEOS DNIE;1;0;0;0;0;0;1
2022;JUNIO;EXTEMPORANEOS/INDOCUMENTADOS DNI AZUL;40;23;10;0;3;2;78
2022;JUNIO;FECHA DE EMISION / DIGITO VERIFICADOR / OTROS DATOS DEL DNI;255;33;16;0;5;1;310
2022;JUNIO;HABILITACIONES;5;0;1;0;0;0;6
2022;JUNIO;HORARIO /AGENCIAS;2513;526;377;3;24;3;3446
2022;JUNIO;IMPUGNACIONES;4;5;2;0;0;0;11
2022;JUNIO;INCIDENCIA GOR;1;1;1;0;0;0;3
2022;JUNIO;INSCRIPCION /C4-C5- NOMBRES IGUALS / NEG SOLTERIA;174;45;10;0;0;1;230
2022;JUNIO;INSCRIPCION DE CERTIFICADO DE DEFUNCION;5;4;0;0;0;0;9
2022;JUNIO;INSCRIPCION DE NACIMIENTO;154;104;18;0;3;1;280
2022;JUNIO;LIBERACION DE PAGO;1;0;0;0;0;0;1
2022;JUNIO;LIBERACION DE TRAMITE;0;0;0;0;0;0;0
2022;JUNIO;MESA DE PARTES - INCONVENIENTES/DEMORA;12;0;1;0;2;0;15
2022;JUNIO;MESA DE PARTES - ORIENTACION TRAMITES;27;37;4;0;1;0;69
2022;JUNIO;OTRAS INCIDENCIAS;66;39;28;0;4;1;138
2022;JUNIO;PAGO NO REFLEJADO EN BASE DE DATOS;33;2;1;0;0;1;37
2022;JUNIO;PASARELA VISA;0;0;0;0;0;0;0
2022;JUNIO;PROBLEMAS - REGISTRO DIGITAL NACIMIENTO;0;0;0;0;0;0;0
2022;JUNIO;PROBLEMAS - RENOVACION DNI WEB;290;16;1;0;1;1;309
2022;JUNIO;PROBLEMAS - SISTEMA OPERATIVO IOS;20;0;0;0;2;0;22
2022;JUNIO;PROBLEMAS DNI BIOFACIAL;78;50;25;2;8;2;165
2022;JUNIO;PROBLEMAS EN USAR LA APLICACION;85;105;36;0;3;2;231
2022;JUNIO;RECOJO DNI;1001;419;109;1;36;7;1573
2022;JUNIO;RECTIFICACION DOMICILIO/ ESTADO CIVIL/OTROS DNI AZUL;464;310;123;4;8;10;919
2022;JUNIO;RECTIFICACION DOMICILIO/ ESTADO CIVIL/OTROS DNIE;39;43;5;0;2;0;89
2022;JUNIO;RECTIFICACION DOMICILIO/FOTO/OTROS DNI AMARILLO;41;39;6;0;0;0;86
2022;JUNIO;RECTIFICACION PARTIDAS;177;119;29;0;2;0;327
2022;JUNIO;RENOVACION CERTIF. DIGITAL/PERSONA NATURAL DNIE;0;1;0;0;0;0;1
2022;JUNIO;RENOVACION CERTIFICADOS DIGITALES/PERSONA CONSULTA PUBLICA;1;0;0;0;0;0;1
2022;JUNIO;RENOVACION DNI AMARILLO;113;193;50;0;0;2;358
2022;JUNIO;RENOVACION DNI AZUL;486;1098;63;0;10;0;1657
2022;JUNIO;RENOVACION DNIE;28;21;3;0;8;0;60
2022;JUNIO;UBICAR ACTA/DIGITALIZACION/ERROR ACTAS;0;0;0;0;0;0;0
